0,0,0,0,0,0,0,0,0,0,0,0,0,0,0,0,
0,1,1,1,1,1,1,1,1,1,1,1,1,0,G,0,
0,1,1,1,1,1,1,K,1,1,1,1,1,0,1,0,
0,1,1,0,0,0,1,1,0,0,0,1,1,0,1,0,
0,1,1,0,0,0,1,1,0,0,0,1,1,0,1,0,
0,1,1,0,0,0,1,1,0,0,0,1,1,0,1,0,
0,1,1,1,1,1,1,1,1,1,1,1,1,0,1,0,
0,1,1,1,1,1,K,E,1,1,1,1,1,0,1,0,
0,1,1,0,0,0,1,1,0,0,0,1,1,0,1,0,
0,1,1,0,0,0,1,1,0,0,0,1,1,0,1,0,
0,1,1,0,0,0,1,1,0,0,0,1,1,0,1,0,
0,1,1,1,1,1,1,1,1,1,1,1,1,0,1,0,
0,1,1,1,1,1,1,1,1,1,1,1,K,0,1,0,
0,1,1,0,0,0,1,1,0,0,0,0,0,0,1,0,
0,1,1,0,0,0,1,1,1,K,1,1,1,1,1,0,
0,0,0,0,0,0,0,0,0,0,0,0,0,0,0,0,