0,0,0,0,0,0,0,0,0,0,0,0,0,0,0,0,
0,1,1,1,1,1,1,1,1,1,1,1,1,1,1,0,
0,1,1,1,1,1,1,1,1,1,1,1,1,1,1,0,
0,0,0,1,1,1,0,K,1,0,1,1,1,0,0,0,
0,1,K,1,1,1,1,1,1,1,1,1,1,1,1,0,
0,1,1,1,1,1,1,1,1,1,1,1,1,K,1,0,
0,0,0,0,0,0,0,0,0,0,0,0,0,0,1,0,
0,1,1,1,1,1,1,1,1,1,1,1,1,0,1,0,
0,1,0,0,0,0,0,0,0,0,0,0,1,0,1,0,
0,1,0,0,0,0,0,0,0,0,0,0,1,0,1,0,
0,1,0,1,1,1,1,1,1,1,1,1,1,0,1,0,
0,1,0,G,1,K,1,1,E,1,1,1,1,0,1,0,
0,1,0,1,1,1,1,1,1,1,1,1,1,0,1,0,
0,1,0,0,0,0,0,0,0,0,0,0,0,0,1,0,
0,1,1,1,1,1,1,1,1,1,1,1,1,1,1,0,
0,0,0,0,0,0,0,0,0,0,0,0,0,0,0,0,